1111111111111111111111111111111111
1E0CY00000000000000000000000000001
1010010100100000101001000Y00010101
1010010010101010001001000C00010101
100C000000P00Y000C000Y0000000000E1
1111111111111111111111111111111111