111111111111111111111111111111
1P011111C011C001000C0100001111
110000000001110100100001100011
110111011C00010000001101C01011
11Y0000000Y0C00010111001100YC1
1C101101111100Y010000010111111
100000Y000C0001101110C0001C001
111001111111000000111110111001
10001100C000000100CY0000000Y01
110100010111110001011110100101
11010111010100Y00000000011C1C1
11010000110101111000110Y100111
1C0000001001110000111011100C11
1101011Y0000C000101C0000101111
1C0101011111110110110111101001
111101000100010C000100C1000001
100001000011011110010111011001
1001100100C100000101Y00000C011
1010100001011011000C1111111111
10C0Y0C0Y100C01C00010C00000011
1110011101110001Y0011011110001
1010111C00100Y0110Y1101C1CY001
101Y00110110010011001000111101
100010YC01E1111000000011010111
10C01101110000C010100Y000000C1
111111111111111111111111111111